0000000000000000000000000000000000
0                                0
0                                0
0                                0 
0                                0
0                                0
0       e                        0
0      w                  w      0
0      07 7 7 7 7 7 7 7 7 0      0
0       6 6 6 6 6 6 6 6 6        0
01 1 1 1 1 1 1 1 1 1 1 1 1 1 1 1 0
03   3   3   3   3   3   3   3   0
0  2   2   2   h   h   2   2   2 0
03   3   3   3   3   3   3   3   0
0d d d d d d d d d d d d d d d d 0