0000000000000000000000000000000000
0                                0
0               E                0
0                                0 
0                                0
0                                0
0             3 h 3              0
0           6 6 6 6 6            0
0e        d d d d d d d e        0
0        w6 6 6 6 6 6 6w         0
06 6 s 6 6 1 1 1 1 1 1 6 6 s 6 6 0
03   3   3             3   3   3 0
0  7 h 7                 7 h 7   0
03   3   3             3   3   3 0
0d d d d d             d d d d d 0